+------------------><(((º>------------------+
|   North                                   |
|   Beach    Mountain    Cave               |
|  +-----+   +-----+    +-----+             |
|  |     |   |     |    |     |             |
|  |     +---+     +----+     |             |
|  |     |   |     |    |     |             |
|  +--+--+   +--+--+    +-----+   Mystical  |
|     |         |                  Grove    |
|  +--+--+   +--+--+    +-----+   +-----+   |
|  |     |   |     |    |     |   |     |   |
|  |     +---+     +----+     +---+     |   |
|  |     |   |     |    |     |   |     |   |
|  +-----+   +-----+    +-----+   +--+--+   |
|   Beach    Jungle    Waterfall     |      |
|                                    |      |
|                                 +--+--+   |
|                                 |     |   |
|                                 |     |   |
|                                 |     |   |
|                                 +-----+   |
|                                 Volcano   |
+------------------><(((º>------------------+